-1 b 0
7 7
WWWWWWW
W.....W
WW.WWWW
W..WW.W
W.W...W
W...WWW
WWWWWWW
1
5 3 a
5 1
